XXXXXXXXXXXXXXXXXXXXXXXXXXXXXXXXXXXXXXXXXXXXXXXXXX
XXXX0 XXXXXXX XX XXX   XX     X XX    XXXX  XX  XX
XXXXX   XXXXX XX  XXXX  X   XXX  XXXX   XXX      X
XX              X XXXXX   X         X XXXXX XXX  X
XXX XXXX  XX  X    X    XXX    XXX      XX  XX  XX
X   X X X  X  XXX    XX  XX   X XX  XXX    X#  X X
XXXXXXXXXXXXXXXXXXXXXXXXXXXXXXXXXXXXXXXXXXXXXXXXXX