XXXXXXXX
X0XX X X
X X  X X
X   X  X
XX     X
X  X  XX
X X  XXX
X   X XX
X X   #X
XXXXXXXX