XXXXXXXXXXXXXXXXXXXXXXXXX
X  X  X      XX    X  XXX
X   X     XX   XX     X#X
XXX   XXX  XX   X  XX   X
X0XX  X X  X  X   X  XX X
X             X  XX  X XX
XXXXXXXXXXXXXXXXXXXXXXXXX